
{
    "startYear":215,
    "year":217,
    "month":10,
    "cityList":[
        [1, 8, 0, 0, 1, 1],
        [2, 8, 0, 0, 2, 1],
        [3, 8, 0, 0, 2, 1],
        [4, 8, 0, 0, 3, 1],
        [5, 8, 0, 0, 4, 1],
        [6, 8, 0, 0, 6, 1],
        [7, 8, 0, 0, 7, 1],
        [8, 7, 0, 0, 1, 1],
        [9, 7, 0, 0, 1, 1],
        [10, 7, 0, 0, 2, 1],
        [11, 7, 0, 0, 2, 1],
        [12, 7, 0, 0, 2, 1],
        [13, 7, 0, 1, 6, 1],
        [14, 7, 0, 1, 6, 1],
        [15, 7, 0, 1, 7, 1],
        [16, 7, 0, 1, 8, 1],
        [17, 6, 0, 0, 1, 1],
        [18, 6, 0, 0, 2, 1],
        [19, 6, 0, 0, 2, 1],
        [20, 6, 0, 0, 2, 1],
        [21, 6, 0, 0, 2, 1],
        [22, 6, 0, 0, 3, 1],
        [23, 6, 0, 0, 3, 1],
        [24, 6, 0, 0, 4, 1],
        [25, 6, 0, 0, 4, 1],
        [26, 6, 0, 0, 4, 1],
        [27, 6, 0, 0, 4, 1],
        [28, 6, 0, 0, 5, 1],
        [29, 6, 0, 0, 5, 1],
        [30, 6, 0, 0, 6, 1],
        [31, 6, 0, 0, 7, 1],
        [32, 6, 0, 0, 8, 1],
        [33, 6, 0, 0, 8, 1],
        [34, 6, 0, 0, 8, 1],
        [35, 5, 0, 0, 1, 1],
        [36, 5, 0, 0, 1, 1],
        [37, 5, 0, 0, 1, 1],
        [38, 5, 0, 0, 2, 1],
        [39, 5, 0, 0, 2, 1],
        [40, 5, 0, 0, 3, 1],
        [41, 5, 0, 0, 3, 1],
        [42, 5, 0, 0, 3, 1],
        [43, 5, 0, 0, 4, 1],
        [44, 5, 0, 0, 4, 1],
        [45, 5, 0, 0, 4, 1],
        [46, 5, 0, 0, 5, 1],
        [47, 5, 0, 0, 5, 1],
        [48, 5, 0, 0, 5, 1],
        [49, 5, 0, 0, 5, 1],
        [50, 5, 0, 0, 5, 1],
        [51, 5, 0, 0, 6, 1],
        [52, 5, 0, 0, 6, 1],
        [53, 5, 0, 0, 6, 1],
        [54, 5, 0, 0, 6, 1],
        [55, 5, 0, 0, 6, 1],
        [56, 5, 0, 0, 7, 1],
        [57, 5, 0, 0, 7, 1],
        [58, 5, 0, 0, 7, 1],
        [59, 5, 0, 0, 7, 1],
        [60, 5, 0, 0, 8, 1],
        [61, 5, 0, 0, 8, 1],
        [62, 5, 0, 0, 8, 1],
        [63, 4, 0, 0, 3, 1],
        [64, 4, 0, 0, 3, 1],
        [65, 4, 0, 0, 3, 1],
        [66, 4, 0, 0, 5, 1],
        [67, 4, 0, 0, 7, 1],
        [68, 4, 0, 0, 8, 1],
        [69, 4, 0, 0, 8, 1],
        [70, 3, 0, 0, 1, 1],
        [71, 3, 0, 0, 2, 1],
        [72, 3, 0, 0, 3, 1],
        [73, 3, 0, 0, 3, 1],
        [74, 3, 0, 0, 2, 1],
        [75, 3, 0, 0, 4, 1],
        [76, 3, 0, 0, 4, 1],
        [77, 2, 0, 0, 1, 1],
        [78, 2, 0, 0, 1, 1],
        [79, 2, 0, 0, 1, 1],
        [80, 2, 0, 2, 2, 1],
        [81, 2, 0, 2, 2, 1],
        [82, 2, 0, 2, 2, 1],
        [83, 2, 0, 2, 2, 1],
        [84, 2, 0, 0, 3, 1],
        [85, 2, 0, 0, 3, 1],
        [86, 2, 0, 3, 4, 1],
        [87, 3, 0, 3, 4, 1],
        [88, 2, 0, 3, 6, 1],
        [89, 2, 0, 3, 6, 1],
        [90, 2, 0, 0, 8, 1],
        [91, 1, 0, 0, 7, 1],
        [92, 1, 0, 0, 7, 1],
        [93, 1, 0, 0, 8, 1],
        [94, 1, 0, 0, 8, 1]
    ],
    "nationList":[
        [1,"위","#0000ff",13],
        [2,"촉","#00ff00",83],
        [3,"오","#ff0000",89]
    ],
    "spyList":[133, 892],
    "shownByGeneralList":[65,33,73],
    "myCity":83,
    "myNation":2
}